10
-.-.P.-.-.P.-.G.-.-
-.-.-.P.-.-.-.-.-.-
-.P P_G.-.B.-.-.-.W.-.-
-.-.-.-.P_G P.-.-.-.-.-
-.-.-.-.-.-.-.-.-.-
-.-.W.-.-.-.-.-.P.-
-.-.-.-.-.-.-.-.-.-
-.-.-.-.W.-.-.-.-.P
-.-.-.-.-.-.-.G.-.-
A.-.-.-.H_P.-.-.-.-.-
