10
-.-.-.-.-.-.-.-.G.-
-.-.-P.-.-.-.-.-.-.-
-.P.-.-.-.-.-.-.-.-.-
-.-.-.-.-.P_G.-.-.-.-
-.-.-.-.-.-.-.-.-.-.
-.W.-.-.-.-.-.-.-.P.-
-.-.-.-.-.-.-.-.-.-.-
.-.-.-.-W.-.-.-.-.-.-
-.-.-.-.-.-.-.-.-.-.-
A.-.-.-.-.-H_P.-.-.-